99 Problems - JAY-Z
Bad Boy for Life - Diddy, Black Rob, Mark Curry
Beamer, Benz, Or Bentley - Lloyd Banks, Juelz Santana
Before I Go - Bizzy Bone
Big Pimpin' - JAY-Z, UGK
Bow Down - Westside Connection
Buy U a Drank - T-Pain, Yung Joc
C-Walk - Kurupt, Tray Dee, Slip Capone
Caribou Lou - Tech N9ne
Castro - Yo Gotti, Kanye West, Big Sean, Quavo, 2 Chainz
Colombia Heights - Wale, J Balvin
Consipracy Theory - Jedi Mind Tricks
Damn It Feels Good to Be a Gangsta - Geto Boys
Dance with the Devil - Immortal Technique
Dear Mama - 2Pac
E.I. - Nelly
Eazy-Duz-It - Eazy-E, Dr. Dre, MC Ren
Forgot About Dre - Dr. Dre, Eminem
Freaky Girl - Gucci Mane
Fuck Tha Police - N.W.A.
Gangsta Rap Made Me Do It - Ice Cube
Going Back to Cali - The Notorious B.I.G.
Hello - Ice Cube, Dr. Dre, MC Ren
I Got 5 On It - Luniz
I Wanna Love You - Akon, Snoop Dogg
I'm A Gangsta - Jadakiss, Parle
Ice Cream Paint Job - Dorrough Music
Jada's Got A Gun - Jadakiss, Eric McCaine, Antoine Stanton
Leather So Soft - Birdman, Lil Wayne
Lowrider - Cypress Hill
Many Men (Wish Death) - 50 Cent
Miami - Will Smith
Money In The Grave - Drake, Rick Ross
Money On My Mind - Lil Wayne
My N**** - YG, Jeezy, Rich Homie Quan
My Name Is - Eminem
New York - Ja Rule, Fat Joe, Jadakiss
Nuthin' But A "G" Thang - Dr. Dre, Snoop Dogg
Oh No - Mos Def, Pharoahe Monch, Nate Dogg
On Fire - Lloyd Banks
One Mic - Nas
Patiently Waiting - 50 Cent, Eminem
Point of No Return - Immortal Technique
Push It - Rick Ross
Ruff Ryders Anthem - DJ Clue, DMX, Jadakiss, Styles, Eve, Drag-On
Shook Ones, Pt. II - Mobb Deep
Simon Says - Pharoahe Monch
Soldier - Eminem
Stan - Eminem, Dido
Still Fly - Big Tymers
Stuntin' Like My Daddy - Birdman, Lil Wayne
Tha Mobb - Lil Wayne
The Real Slim Shady - Eminem
The Way I Am - Eminem
Time's Up - Jadakiss, Nate Dogg
Welcome To Atlanta Remix - Jermaine Dupri, Diddy, Snoop Dogg, Murphy Lee
What If - Jadakiss, Nas
When I Die - Krayzie Bone, Fat Joe, Big Pun, Layzie Bone
Where The Hood At - DMX
White America - Eminem
Who Shot Ya? - The Notorious B.I.G.
Work It - Missy Elliott
Young N***** - Gucci Mane, Waka Flocka Flame
Yung and Bhad - Bhad Bhabie, City Girls
