#1 Stunna - Big Tymers, JUVENILE, Lil Wayne
Ambitionz Az A Ridah - 2Pac
Aston Martin Music - Rick Ross, Drake, Chrisette Michele
Back That Azz Up - JUVENILE, Lil Wayne, Mannie Fresh
Big Bank - YG, 2 Chainz, Big Sean, Nicki Minaj
Blow the Whistle - Too $hort
Boyz-N-The-Hood - Eazy-E
Crazy Rap (Colt 45 & 2 Zig Zags) - Afroman
Da Graveyard - Big L
Deuces - Chris Brown, Tyga, Kevin McCall
Dirt Off Your Shoulder - JAY-Z
Don't Tell 'Em - Jeremih, YG
Down On Me - Jeremih, 50 Cent
Drug Dealers Anonymous - Pusha T, JAY-Z
Feels - Tory Lanez, Chris Brown
Furthest Thing - Drake
Get Your Roll On - Big Tymers
Gettin' Jiggy Wit It - Will Smith
Gin and Juice - Snoop Dogg
Go To Church - Ice Cube, Lil Jon, Snoop Dogg
Got Ur Self A Gun - Nas
Guilty Conscience - Eminem, Dr. Dre
Hard in Da Paint - Waka Flocka Flame
Hot N**** - Bobby Shmurda
Hustlin' - Rick Ross
I Can - Nas
I'm Not a Player - Big Pun
I'm On One - DJ Khaled, Drake, Rick Ross, Lil Wayne
INDUSTRY BABY - Lil Nas X, Jack Harlow
Killa Cam / Roll That Skit - Cam'ron
King Kong - Jibbs, Chamillionaire
Late Night Hour - Ice Cube, Pusha T
Lay Low - Snoop Dogg, Master P, Nate Dogg, Butch Cassidy, Tha Eastsidaz
Like A Pimp - David Banner, Lil' Flip
Marvins Room - Drake
Men In Black - Will Smith
My Chain - Gucci Mane
N.Y. State of Mind - Nas
No Frauds - Nicki Minaj, Drake, Lil Wayne
Nonstop - Drake
Over Here Hustlin' - Birdman, Lil Wayne
Pillz - Gucci Mane
Platinum Plus - Big L, Big Daddy Kane
Play - David Banner
Quiet Storm - Mobb Deep
Rap Game - D12, 50 Cent
Ready to Die - The Notorious B.I.G.
Regulate - Warren G, Nate Dogg
Role Model - Eminem
shining on my ex - BABY GRAVY, Yung Gravy, bbno$
Shot For Me - Drake
Straight Outta Compton - N.W.A.
Survival of the Fittest - Mobb Deep
Ten Crack Commandments - The Notorious B.I.G.
Tha Shiznit - Snoop Dogg
The 4th Branch - Immortal Technique
The Next Episode - Dr. Dre, Snoop Dogg
What's Beef? - The Notorious B.I.G.
What's The Difference - Dr. Dre, Eminem, Xzibit
What's Your Fantasy - Ludacris, Shawnna
Without Me - Eminem
Work Out - J. Cole
WW III - Ruff Ryders, Snoop Dogg, Scarface, Jadakiss, Yung Wun
You Ain't a Killer - Big Pun
