All I Do Is Win - DJ Khaled
Back To Back - Drake
Better Now - Post Malone
Bitch Please - Snoop Dogg, Xzibit
Blessing - 2 Chainz
Blue C-Note - 2 Chainz, Lil Wayne
Brain Damage - Eminem
Chirp - 2 Chainz
Crumblin' Erb - Outkast
Don’t Stop - Megan Thee Stallion, Young Thug
Drowning - A Boogie Wit da Hoodie, Kodak Black
Empire State Of Mind - JAY-Z, Alicia Keys
Flexicution - Logic
Free Enterprise - Rick Ross, John Legend
Get By - Talib Kweli
Ghetto - 2 Chainz
Hate On Me - Kurupt, Priest "Soopafly" Brooks, Damani
Hurt a N**** Feelings - Gucci Mane
I'm Upset - Drake
If I Had - Eminem
Industrial Revolution - Immortal Technique
Kyoto - Yung Lean
Like That - Doja Cat, Gucci Mane
Lil Haiti Baby - Future
Love Me - Lil Wayne, Drake, Future
Lovin On Me - Jack Harlow
Oh Boy - Cam'ron, Juelz Santana
One Dance - Drake, Wizkid, Kyla
Pilot - 50 Cent
Planes - Jeremih, J. Cole
Powers That Be - Rick Ross, Nas
Pray 4 Love - Travis Scott, The Weeknd
R.I.P. - Jeezy, 2 Chainz
Rap Saved Me - 21 Savage, Offset, Metro Boomin, Quavo
Re-up - Gucci Mane
Rich As Fuck - Lil Wayne, 2 Chainz
Role Model Freestyle - Diabolic
Sippin On Some Syrup - Three 6 Mafia, UGK, Project Pat
Sneakin’ - Drake, 21 Savage
So Many Ways - Warren G, Wayniac, Lady Levi
Space Jam - Quad City DJ's
St. Brick Intro - Gucci Mane
Stay Schemin - Rick Ross, French Montana, Drake
Swing - Savage
The Ghetto - Too $hort
The Language - Drake
Throw Some D's - Rich Boy, Polow Da Don
Tip Toe Wing In My Jawwwdinz - Riff Raff
Try Me - DeJ Loaf
Wicked - Future
Xanny Family - Future
Yeah Glo! - GloRilla
