(Rock) Superstar - Cypress Hill, Chino Moreno, Everlast
0 To 100 / The Catch Up - Drake
A N**** Witta Gun - Dr. Dre
Act Right - Yo Gotti, Jeezy, YG
Act Up - City Girls
Ain't Got No Haters - Ice Cube, Too $hort
All Eyez On Me - 2Pac, Big Syke
All For Tha Ca$h - Gang Starr
Always On Time - Ja Rule, Ashanti
Area Codes - Ludacris, Nate Dogg
Back On - Gucci Mane
Bad Business - 21 Savage
Bartier Cardi - Cardi B, 21 Savage
Because I Got High - Afroman
Beware - Big Pun
Bicken Back Being Bool - YG
Birthday Song - 2 Chainz, Kanye West
Bitches Ain't Shit - Dr. Dre, Snoop Dogg, Daz, Kurupt, Jewell
Breathin - 2Pac, Outlawz
Cameras / Good Ones Go Interlude - Drake
Candy Shop - 50 Cent, Olivia
Captain Hook - Megan Thee Stallion
Câ€™est La Vie - Yung Gravy, bbno$, Rich Brian
Chain Hang Low - Jibbs
Chin Check - N.W.A.
Cleanin' Out My Closet - Eminem
Comin Out Strong - Future, The Weeknd
Country Grammar - Nelly
Crack - 2 Chainz
Criminal - Eminem
Dead Wrong - The Notorious B.I.G., Eminem
Deadly Combination - Big L, 2Pac
Disco Inferno - 50 Cent
Ebonics - Big L
Fatty Boom Boom - Die Antwoord
Flamboyant - Big L
Gangsta Nation - Westside Connection
Gangsta's Paradise - Coolio, L.V.
Geek'd - Bhad Bhabie, Lil Baby
Get Back - Ludacris
Get Buck In Here - DJ Felli Fel, Diddy, Akon, Ludacris, Lil Jon
Get Right Witcha - Migos
Ghostface Killers - 21 Savage, Offset, Metro Boomin, Travis Scott
Girls in the Hood - Megan Thee Stallion
Going Bad - Meek Mill, Drake
Gotta Lotta - 2 Chainz, Lil Wayne
Grillz - Nelly, Paul Wall, Ali & Gipp
Gucci On My - Mike WiLL Made-It, 21 Savage, YG, Migos
He Got Game - Public Enemy, Stephen Stills
Hey Ma - Cam'ron, Juelz Santana, Freekey Zeekey, Toya
High All The Time - 50 Cent
Hip-Hop - Dead Prez
Hits from the Bong - Cypress Hill
Holy Grail - JAY-Z, Justin Timberlake
Hustler Musik - Lil Wayne
I Just Wanna Party - YG, ScHoolboy Q, Jay Rock
I'm Back - Eminem
Iced Out - Lil Pump, 2 Chainz
If I Can't - 50 Cent
In Da Club - 50 Cent
Izzo - JAY-Z
Just A Lil Bit - 50 Cent
Just Don't Give A Fuck - Eminem
Kill You - Eminem
Knock Yourself Out - Jadakiss, Pharrell Williams
Left, Right - YG, Mustard
Let Me Ride - Dr. Dre, Snoop Dogg, RBX, Jewell
Life Goes On - 2Pac
Livin' It Up - Ja Rule, Case
Lollipop - Lil Wayne, Static Major
Loss 4 Wrdz - Gucci Mane, Rick Ross
LUV - Tory Lanez
Man's Not Hot - Big Shaq
Mask Off - Future
Mass Appeal - Gang Starr
Maybach - Future
Met Gala - Gucci Mane, Offset
Molly - Tyga, Cedric Gervais, Wiz Khalifa, Mally Mall
Move Bitch - Ludacris, Mystikal, I-20
Music & Me - Nate Dogg
My Chick Bad - Ludacris, Nicki Minaj
My Mind Playin Tricks on Me - Geto Boys
No Hands - Waka Flocka Flame, Roscoe Dash, Wale
No Lie - 2 Chainz, Drake
No Reason - Mustard, YG, Jeezy, Nipsey Hussle, RJ
No Worries - Lil Wayne, Detail
Notorious Thugs - The Notorious B.I.G.
Numb - 21 Savage
On, Onsite - Kurupt, Sean Cruse, Lil 1/2 Dead
Only God Can Judge Me - 2Pac, Rappin' 4-Tay
oops! - Yung Gravy
Out The Pound - Birdman, Lil Wayne
Over My Dead Body - Drake
Party Up - DMX
Player's Anthem - Junior M.A.F.I.A.
Pussy Talk - City Girls, Doja Cat
redrum - 21 Savage
Rich Flex - Drake, 21 Savage
Rite Where U Stand - Gang Starr, Jadakiss
rockstar - Post Malone, 21 Savage
Ruff Ryders' Anthem - DMX
Runnin - 21 Savage, Metro Boomin
Sing For The Moment - Eminem
Skateboard P - MadeinTYO, Big Sean
Smokin' Rollin' - Juicy J, Pimp C
So Good - Big Sean, Metro Boomin, Kash Doll
Space Boogie - Kurupt, The Velvet Orchestra, Fredwreck Nassar, Nate Dogg
Spanish Plug - Gucci Mane
St. Louie - Nelly
Started - Iggy Azalea
Steppin On N****s - 21 Savage, Metro Boomin
Still D.R.E. - Dr. Dre, Snoop Dogg
Suicide - Jedi Mind Tricks
Supastars - Migos
Take Care - Drake, Rihanna
The Dream Shatterer - Big Pun
The Motto - Drake, Lil Wayne
The Type - Curren$y, The Alchemist, Prodigy
Too Good - Drake, Rihanna
Too Much - Drake, Sampha
Wanna Be A Baller - Lil' Troy
WAP - Cardi B, Megan Thee Stallion
We Right Here - DMX
WHATS POPPIN - Jack Harlow
White Iverson - Post Malone
Wild Wild West - Will Smith, Dru Hill, Kool Moe Dee
X Gon' Give It To Ya - DMX
Xxplosive - Dr. Dre, Hittman, Six-Two, Nate Dogg, Kurupt
