99 Problems - JAY-Z
Bad Boy for Life - Diddy, Black Rob, Mark Curry
Big Pimpin' - JAY-Z, UGK
Bow Down - Westside Connection
Buy U a Drank - T-Pain, Yung Joc
C-Walk - Kurupt, Tray Dee, Slip Capone
Caribou Lou - Tech N9ne
Castro - Yo Gotti, Kanye West, Big Sean, Quavo, 2 Chainz
Colombia Heights - Wale, J Balvin
Damn It Feels Good to Be a Gangsta - Geto Boys
Eazy-Duz-It - Eazy-E, Dr. Dre, MC Ren
Hello - Ice Cube, Dr. Dre, MC Ren
I Got 5 On It - Luniz
I'm A Gangsta - Jadakiss, Parle
Ice Cream Paint Job - Dorrough Music
Jada's Got A Gun - Jadakiss, Eric McCaine, Antoine Stanton
Leather So Soft - Birdman, Lil Wayne
Lowrider - Cypress Hill
New York - Ja Rule, Fat Joe, Jadakiss
Oh No - Mos Def, Pharoahe Monch, Nate Dogg
Patiently Waiting - 50 Cent, Eminem
Point of No Return - Immortal Technique
Push It - Rick Ross
Ruff Ryders Anthem - DJ Clue, DMX, Jadakiss, Styles, Eve, Drag-On
Shook Ones, Pt. II - Mobb Deep
Simon Says - Pharoahe Monch
Soldier - Eminem
The Real Slim Shady - Eminem
Time's Up - Jadakiss, Nate Dogg
White America - Eminem
Work It - Missy Elliott
Yung and Bhad - Bhad Bhabie, City Girls
